tdulcet	tealdulcet.ddns.net
patter5	megmurry.ddns.net
relsqui	cupcake.chiliahedron.com
pyrrh	souffle.chiliahedron.com
aarong	TBD
mancat	inchworm.mindtax.net
dom	mahan.mindtax.net
brodie	solar.noip.me
chupacabra	chupa-cabra.ddns.net
paolo2	pirr.ddns.net
mrme	mrme.ddns.net
manpreet20	manpreet.ddns.net
huyng90	huyng90.ddns.net
rhatchet	pi.arenjae.com
natreed natreed.ddns.net
leng	lengpi.ddns.net
aldridge85	csjosh.ddns.net
etsai	etsai.ddns.net
jbucklin	jbucklin.ddns.net
po8	po8.org